20,20,1
Close Encounters
1,2,10,6
2,2,1
2,2,2,2,2,2,2,2,2,2,2,2,2,2,2,2,2,2,2,2
2,6,1,1,1,1,1,1,1,1,1,1,1,1,1,1,1,1,1,2
2,1,1,1,1,1,2,1,1,2,1,2,2,2,2,2,2,2,1,2
2,1,1,1,1,1,2,1,1,2,1,2,1,1,1,1,1,2,1,2
2,1,2,1,2,1,2,1,1,2,1,1,1,1,1,1,1,1,1,2
2,1,2,1,2,1,1,1,1,2,1,2,1,1,2,1,1,2,1,2
2,1,2,2,2,2,1,1,1,2,1,2,1,1,2,1,1,2,1,2
2,1,2,1,1,1,1,1,1,2,2,2,1,1,2,1,1,2,1,2
2,1,2,1,1,1,1,1,1,1,1,1,1,1,2,1,1,1,1,2
2,2,2,2,1,2,2,2,1,1,1,1,1,2,2,2,2,1,2,2
2,2,1,2,1,2,2,2,1,1,1,1,1,2,1,1,1,1,1,2
2,1,1,1,1,1,1,1,1,1,1,1,1,1,1,1,1,1,1,2
2,1,2,1,1,1,2,1,1,2,1,2,2,2,2,2,1,1,1,2
2,1,2,1,1,1,2,1,1,2,1,2,1,1,1,1,1,1,1,2
2,1,2,1,1,1,2,2,1,2,1,1,1,1,1,2,1,1,1,2
2,1,2,2,2,1,1,2,1,2,1,1,1,1,2,2,1,2,1,2
2,1,1,2,2,2,1,2,1,2,1,2,2,2,2,1,1,2,1,2
2,2,1,2,1,1,1,2,1,2,2,2,1,1,2,2,1,1,1,2
2,2,1,1,1,1,1,1,1,1,1,1,1,1,2,1,1,2,1,2
2,2,2,2,2,2,2,2,2,2,2,2,2,2,2,2,2,2,2,2
10,9
13,10
4,8
2,17
9,14
12,12
3,4
6,6
8,6
18,18
9,9
10,10
9,11
11,9
11,11
12,12
