40,20,1
Help!
1,2,20,10
6,6,1
2,2,2,2,2,2,2,2,2,2,2,2,2,2,2,2,2,2,2,2,2,2,2,2,2,2,2,2,2,2,2,2,2,2,2,2,2,2,2,2
2,1,1,1,1,1,1,1,1,1,1,1,1,1,1,1,1,1,1,1,1,1,1,1,1,1,1,1,1,1,1,1,1,1,1,1,1,1,1,2
2,1,2,1,1,1,1,1,2,1,2,2,2,2,2,2,2,1,2,2,1,1,1,1,1,1,2,2,2,2,2,1,1,1,1,2,2,1,1,2
2,1,2,1,1,1,1,1,2,1,2,1,1,1,1,1,1,1,2,2,1,1,1,1,1,1,2,2,2,2,2,2,1,1,1,2,2,1,1,2
2,1,2,1,1,1,1,1,2,1,2,1,1,1,1,1,1,1,2,2,1,1,1,1,1,1,2,2,1,1,2,2,1,1,1,2,2,1,1,2
2,1,2,1,1,6,1,1,2,1,2,1,1,1,1,1,1,1,2,2,1,1,1,1,1,1,2,2,1,1,1,2,2,1,1,2,2,1,1,2
2,1,2,1,1,1,1,1,2,1,2,1,1,1,1,1,1,1,2,2,1,1,1,1,1,1,2,2,1,1,1,2,2,1,1,2,2,1,1,2
2,1,2,1,1,1,1,1,2,1,2,1,1,1,1,1,1,1,2,2,1,1,1,1,1,1,2,2,1,1,1,2,2,1,1,2,2,1,1,2
2,1,1,1,1,1,1,1,1,1,1,1,1,1,1,1,1,1,2,2,1,1,1,1,1,1,2,2,1,1,2,2,1,1,1,2,2,1,1,2
2,1,2,2,2,2,2,2,2,1,2,2,2,2,2,1,1,1,2,2,1,1,1,1,1,1,2,2,1,2,2,1,1,1,1,2,2,1,1,2
2,1,2,2,2,2,2,2,2,1,2,2,2,2,2,1,1,1,2,2,1,1,1,1,1,1,2,2,1,2,1,1,1,1,1,2,2,1,1,2
2,1,1,1,1,1,1,1,1,1,1,1,1,1,1,1,1,1,2,2,1,1,1,1,1,1,2,2,1,1,1,1,1,1,1,2,2,1,1,2
2,1,2,1,1,1,1,1,2,1,2,1,1,1,1,1,1,1,2,2,1,1,1,1,1,1,2,2,1,1,1,1,1,1,1,2,2,1,1,2
2,1,2,1,1,1,1,1,2,1,2,1,1,1,1,1,1,1,2,2,1,1,1,1,1,1,2,2,1,1,1,1,1,1,1,2,2,1,1,2
2,1,2,1,1,1,1,1,2,1,2,1,1,1,1,1,1,1,2,2,1,1,1,1,1,1,2,2,1,1,1,1,1,1,1,2,2,1,1,2
2,1,2,1,1,1,1,1,2,1,2,1,1,1,1,1,1,1,2,2,1,1,1,1,1,1,2,2,1,1,1,1,1,1,1,1,1,1,1,2
2,1,2,1,1,1,1,1,2,1,2,1,1,1,1,1,1,1,2,2,2,2,2,2,2,1,2,2,1,1,1,1,1,1,1,2,2,1,1,2
2,1,2,1,1,1,1,1,2,1,2,2,2,2,2,2,2,1,2,2,2,2,2,2,2,1,2,2,1,1,1,1,1,1,1,2,2,1,1,2
2,1,1,1,1,1,1,1,1,1,1,1,1,1,1,1,1,1,1,1,1,1,1,1,1,1,1,1,1,1,1,1,1,1,1,1,1,1,1,2
2,2,2,2,2,2,2,2,2,2,2,2,2,2,2,2,2,2,2,2,2,2,2,2,2,2,2,2,2,2,2,2,2,2,2,2,2,2,2,2
2,2
2,13
5,15
16,5
18,18
9,9
5,9
16,8
10,18
29,9
22,13
25,10
26,5
28,19
39,9
34,5
23,15
29,16
29,5
19,19
10,10
18,10
11,9
29,17
31,13
37,16
34,14
23,16
28,2
16,16
