40,20,2
Lift Me Up
1,2,30,20
3,3,1
2,2,2,2,2,2,2,2,2,2,2,2,2,2,2,2,2,2,2,2,2,2,2,2,2,2,2,2,2,2,2,2,2,2,2,2,2,2,2,2
2,1,1,1,1,1,1,1,1,1,1,1,1,1,1,1,1,1,1,1,1,1,1,1,1,1,1,1,1,1,1,1,1,1,1,1,1,1,1,2
2,1,6,1,1,1,1,1,1,1,1,1,1,1,1,1,1,1,1,1,1,1,1,1,1,1,1,1,1,1,1,1,1,1,1,1,2,1,1,2
2,1,1,1,2,1,1,2,1,1,2,1,1,1,1,1,2,2,2,2,2,2,2,2,2,2,2,2,2,1,1,1,1,1,1,1,2,1,1,2
2,1,1,1,2,1,1,2,1,1,2,1,1,1,1,1,2,1,1,1,1,1,1,1,1,1,1,1,2,1,1,1,1,1,1,1,2,1,1,2
2,1,1,1,2,1,1,2,1,1,2,1,1,1,1,1,2,1,2,2,2,2,2,2,2,2,2,1,2,1,1,1,1,1,1,1,2,1,1,2
2,1,1,2,2,2,2,2,2,2,2,2,1,1,1,1,2,1,2,1,1,1,1,1,1,1,2,1,2,1,1,1,1,1,1,1,2,1,1,2
2,1,1,2,1,1,1,1,1,1,1,2,2,2,2,1,2,1,2,1,2,2,2,2,2,1,2,1,2,1,1,2,2,2,2,2,2,1,1,2
2,1,1,2,1,2,2,2,2,2,1,2,1,1,1,1,2,1,2,1,2,1,1,1,2,1,2,1,2,1,1,2,1,1,1,1,1,1,1,2
2,1,1,2,1,2,2,2,2,2,1,2,1,1,1,1,2,1,2,1,2,1,2,1,2,1,2,1,2,1,1,2,1,1,1,1,1,1,1,2
2,1,1,2,1,2,2,5,2,2,1,2,2,2,2,1,2,1,1,1,1,1,1,1,1,1,1,1,2,1,1,2,1,1,1,1,1,1,1,2
2,1,1,2,1,2,2,1,2,2,1,2,1,1,1,1,2,1,2,1,2,1,2,2,2,1,2,1,2,1,1,2,1,1,1,1,1,1,1,2
2,1,1,2,1,2,2,1,2,2,1,2,1,1,1,1,2,1,2,1,2,1,1,1,1,1,2,1,2,1,1,2,1,1,1,1,1,1,1,2
2,1,1,2,1,1,1,1,1,1,1,2,2,2,2,1,2,1,2,1,2,2,2,2,2,2,2,1,2,1,1,2,1,1,1,1,1,1,1,2
2,1,1,2,1,1,1,1,1,1,1,2,1,1,1,1,2,1,2,1,1,1,1,1,1,1,1,1,2,1,1,2,1,1,1,1,1,1,1,2
2,1,1,1,1,1,1,1,1,1,1,1,1,1,1,1,2,1,2,2,2,2,2,2,2,2,2,2,2,1,1,2,2,2,2,2,2,2,2,2
2,1,1,1,1,1,1,1,1,1,1,1,1,1,1,1,1,1,1,1,1,1,1,1,1,1,1,1,1,1,1,1,1,1,1,1,1,1,1,2
2,1,1,1,1,1,1,1,1,1,1,1,1,1,1,1,1,1,1,1,1,1,1,1,1,1,1,1,1,1,1,1,1,1,1,1,1,1,1,2
2,1,1,1,1,1,1,1,1,1,1,1,1,1,1,1,1,1,1,1,1,1,1,1,1,1,1,1,1,1,1,1,1,1,1,1,1,1,1,2
2,2,2,2,2,2,2,2,2,2,2,2,2,2,2,2,2,2,2,2,2,2,2,2,2,2,2,2,2,2,2,2,2,2,2,2,2,2,2,2
2,2,2,2,2,2,2,2,2,2,2,2,2,2,2,2,2,2,2,2,2,2,2,2,2,2,2,2,2,2,2,2,2,2,2,2,2,2,2,2
2,2,1,1,1,1,1,1,1,1,1,1,1,1,1,2,1,1,1,1,1,1,1,1,1,1,1,2,1,1,1,1,1,1,1,1,1,1,1,2
2,2,1,2,1,2,2,2,2,2,2,2,1,2,1,1,1,2,2,2,2,1,1,1,1,2,1,2,1,2,2,2,2,2,2,2,2,2,1,2
2,2,1,2,1,1,1,1,1,1,1,2,1,2,2,2,2,2,1,1,2,2,2,2,1,2,1,1,1,2,1,1,1,1,1,1,1,2,1,2
2,2,1,2,2,1,2,2,2,2,1,1,1,1,1,1,1,1,1,1,1,1,1,2,1,2,1,2,1,2,1,2,2,2,2,2,1,2,1,2
2,2,1,2,1,1,2,1,1,1,1,2,2,2,2,2,2,2,2,2,2,2,1,2,1,2,1,1,1,2,1,2,1,1,1,2,1,2,1,2
2,2,1,2,2,2,2,1,2,2,2,2,1,1,1,1,1,1,1,1,1,2,1,2,1,2,2,2,2,2,1,2,1,2,1,2,2,2,1,2
2,2,1,1,1,1,1,1,1,1,1,2,1,2,2,2,1,2,2,2,1,2,1,1,1,1,1,1,1,1,1,1,1,2,1,1,1,1,1,2
2,2,1,2,1,2,2,2,2,2,1,2,1,2,1,1,1,1,1,2,1,2,2,2,1,1,1,1,1,1,1,1,1,2,2,2,2,2,1,2
2,2,1,2,1,2,2,2,2,2,1,2,1,2,1,2,2,2,1,2,1,1,1,1,1,1,1,1,1,1,1,1,1,1,1,1,1,2,1,2
2,1,1,2,1,2,2,5,2,2,1,2,1,2,1,2,1,2,1,2,2,2,2,2,1,1,1,1,1,1,1,1,1,1,1,1,1,2,1,2
2,1,2,2,1,2,2,1,2,2,1,1,1,2,1,2,1,2,1,1,1,2,1,1,1,2,2,1,1,1,1,1,1,1,1,1,1,2,1,2
2,1,2,1,1,2,2,1,2,2,2,2,2,2,1,2,1,2,1,2,1,2,1,2,2,2,1,1,1,1,1,1,1,1,1,1,1,1,1,2
2,1,2,2,1,1,1,1,1,1,1,1,1,1,1,2,1,2,1,2,1,2,1,2,2,2,2,2,2,2,2,2,2,1,1,2,2,2,1,2
2,1,2,1,1,2,2,2,2,2,2,2,2,2,2,2,1,2,1,2,1,1,1,1,1,1,1,1,1,1,1,1,2,1,1,2,1,2,1,2
2,1,2,2,1,2,2,2,2,2,1,1,1,1,1,1,1,1,1,2,2,2,2,2,1,2,2,2,2,2,2,2,2,1,1,2,1,2,1,2
2,1,2,1,1,1,1,1,1,1,1,2,2,2,2,2,2,2,1,1,1,1,1,1,1,1,1,2,1,2,1,2,2,1,1,2,1,2,1,2
2,1,2,1,2,2,2,2,1,2,2,2,1,1,1,1,1,2,2,2,2,2,1,2,2,2,2,2,1,2,1,2,2,2,2,2,1,2,1,2
2,1,1,1,2,1,1,1,1,1,1,1,1,2,2,2,1,1,1,1,1,1,1,1,1,1,1,1,1,1,1,1,1,1,1,1,1,1,1,2
2,2,2,2,2,2,2,2,2,2,2,2,2,2,2,2,2,2,2,2,2,2,2,2,2,2,2,2,2,2,2,2,2,2,2,2,2,2,2,2
6,6,1
23,7,1
8,8,1
8,12,1
24,13,1
33,15,1
39,15,1
20,2,1
38,2,1
30,19,1
32,4,1
28,5,1
31,10,1
13,12,1
22,10,1
11,17,2
10,14,2
18,2,2
27,13,2
34,10,2
16,18,2
2,18,2
19,7,2
5,6,2
37,6,2
37,17,2
32,4,2
39,7,2
23,6,2
28,8,2
11,10,1
2,18,1
38,19,1
32,2,1
18,16,1
24,13,1
39,10,1
23,17,1
23,7,1
14,12,1
32,15,2
37,15,2
34,6,2
20,4,2
11,10,2
3,2,2
4,15,2
15,18,2
17,8,2
17,15,2
