20,20,5
"The Tower"
2,4,35,30
13,16,5
2,2,2,2,2,2,2,2,2,2,2,2,2,2,2,2,2,2,2,2,2,1,1,1,1,1,1,1,1,1,1,1,1,1,1,1,1,1,5,2,2,1,1,1,1,1,1,1,1,1,1,1,1,1,1,1,1,1,1,2,2,1,1,2,2,2,2,2,2,1,1,2,2,2,2,2,2,1,1,2,2,1,1,2,2,2,2,1,1,1,1,1,1,2,2,2,2,1,1,2,2,1,1,2,2,2,1,1,1,1,1,1,1,1,2,2,2,1,1,2,2,1,1,2,2,1,1,1,1,1,1,1,1,1,1,2,2,1,1,2,2,1,1,2,1,1,1,2,2,1,1,2,2,1,1,1,2,1,1,2,2,1,1,2,1,1,1,2,1,1,1,1,2,1,1,1,2,1,1,2,2,1,1,1,1,1,1,1,1,2,2,1,1,1,1,1,1,1,1,2,2,1,1,1,1,1,1,1,1,2,2,1,1,1,1,1,1,1,1,2,2,1,1,2,1,1,1,2,1,1,1,1,2,1,1,1,2,1,1,2,2,1,1,2,1,1,1,2,2,1,1,2,2,1,1,1,2,1,1,2,2,1,1,2,2,1,1,1,1,1,1,1,1,1,1,2,2,1,1,2,2,1,1,2,2,2,1,1,1,1,1,1,1,1,2,2,2,1,1,2,2,1,1,2,2,2,2,1,1,1,1,1,1,2,2,2,2,1,1,2,2,1,1,2,2,2,2,2,2,1,1,2,2,2,2,2,2,1,1,2,2,1,1,1,1,1,1,1,1,1,1,1,1,1,1,1,1,1,1,2,2,5,1,1,1,1,1,1,1,1,1,1,1,1,1,1,1,1,1,2,2,2,2,2,2,2,2,2,2,2,2,2,2,2,2,2,2,2,2,2
2,2,2,2,2,2,2,2,2,2,2,2,2,2,2,2,2,2,2,2,2,1,1,1,1,1,1,1,1,1,1,1,1,1,1,1,1,2,5,2,2,1,2,2,2,2,2,2,2,2,2,2,2,2,2,2,1,2,1,2,2,1,1,1,1,1,1,1,1,1,2,1,1,1,1,2,1,2,1,2,2,1,2,2,2,2,2,2,2,1,2,1,1,1,1,2,1,2,1,2,2,1,2,1,1,1,1,2,2,1,2,1,1,1,1,2,1,1,1,2,2,1,2,1,2,2,1,2,2,1,2,1,1,1,1,2,1,2,1,2,2,1,2,1,2,2,1,2,2,1,2,2,1,2,1,2,1,2,1,2,2,1,2,1,2,2,1,1,1,1,1,2,1,2,1,2,1,2,1,2,2,1,2,1,2,2,2,2,2,2,1,2,1,2,1,2,1,2,1,2,2,1,2,1,1,1,1,1,1,1,1,1,1,2,1,2,1,2,1,2,2,1,2,1,2,2,1,2,2,2,1,2,1,2,1,2,1,2,1,2,2,1,2,1,2,2,1,1,1,1,1,2,1,1,1,1,1,1,1,2,2,1,2,1,2,2,1,1,1,1,1,2,1,2,1,2,1,2,1,2,2,1,2,1,2,2,1,1,1,1,1,2,1,2,1,2,1,2,1,2,2,1,2,1,1,1,1,1,1,1,1,1,1,2,1,2,1,2,1,2,2,1,2,1,2,2,1,2,2,2,2,2,1,2,1,2,1,2,1,2,2,1,2,1,2,2,1,2,2,2,2,2,1,2,1,2,1,2,1,2,2,5,1,1,1,1,1,1,1,1,1,1,1,1,1,1,1,1,1,2,2,2,2,2,2,2,2,2,2,2,2,2,2,2,2,2,2,2,2,2
2,2,2,2,2,2,2,2,2,2,2,2,2,2,2,2,2,2,2,2,2,1,1,1,1,1,1,1,1,1,1,1,1,1,1,1,1,1,5,2,2,1,1,1,1,1,1,1,2,1,1,2,1,1,1,1,1,1,1,2,2,1,1,2,2,2,2,1,2,1,1,2,1,2,2,2,2,1,1,2,2,1,1,2,1,1,2,1,2,1,1,2,1,2,1,1,2,1,1,2,2,1,1,2,1,1,2,1,2,2,2,2,1,2,1,1,2,1,1,2,2,1,1,2,1,1,2,1,1,1,1,1,1,2,1,1,2,1,1,2,2,1,1,2,1,1,2,1,1,1,1,1,1,2,1,1,2,1,1,2,2,1,1,2,1,1,2,1,1,1,1,1,1,2,1,1,2,1,1,2,2,1,1,2,1,1,1,1,1,1,1,1,1,1,1,1,2,1,1,2,2,1,1,2,1,1,1,1,1,1,1,1,1,1,1,1,2,1,1,2,2,1,1,2,1,1,2,1,1,1,1,1,1,2,1,1,2,1,1,2,2,1,1,2,1,1,2,1,1,1,1,1,1,2,1,1,2,1,1,2,2,1,1,2,1,1,2,1,1,1,1,1,1,2,1,1,2,1,1,2,2,1,1,2,1,1,2,1,2,2,2,2,1,2,1,1,2,1,1,2,2,1,1,2,1,1,2,1,2,1,1,2,1,2,1,1,2,1,1,2,2,1,1,2,2,2,2,1,2,1,1,2,1,2,2,2,2,1,1,2,2,1,1,1,1,1,1,1,2,1,1,2,1,1,1,1,1,1,1,2,2,5,1,1,1,1,1,1,1,1,1,1,1,1,1,1,1,1,1,2,2,2,2,2,2,2,2,2,2,2,2,2,2,2,2,2,2,2,2,2
2,2,2,2,2,2,2,2,2,2,2,2,2,2,2,2,2,2,2,2,2,1,1,1,1,1,1,1,1,1,1,1,1,1,1,1,1,1,5,2,2,1,2,2,2,2,2,1,2,1,1,2,1,2,2,2,1,1,1,2,2,1,1,1,2,1,1,1,2,1,1,2,1,2,1,1,1,1,1,2,2,1,1,1,2,1,1,1,2,2,2,2,1,2,2,1,1,1,1,2,2,1,1,1,2,1,1,1,2,1,1,2,1,2,1,1,1,1,1,2,2,1,1,1,2,1,1,1,2,1,1,2,1,2,2,2,1,1,1,2,2,1,1,1,1,1,1,1,1,1,1,1,1,1,1,1,1,1,1,2,2,1,2,2,2,1,2,2,2,1,2,1,2,1,2,1,1,1,1,2,2,1,1,2,1,1,2,1,2,1,2,1,2,1,2,1,1,1,1,2,2,1,1,2,1,1,2,1,2,1,2,1,2,1,2,1,2,2,1,2,2,1,1,2,1,1,2,1,2,1,1,2,1,2,1,1,1,1,1,2,2,1,1,2,1,1,2,2,2,1,1,2,1,2,1,1,1,1,1,2,2,1,1,1,1,1,1,1,1,1,1,1,1,1,1,1,1,1,1,2,2,1,1,1,1,1,2,2,2,1,2,2,1,1,1,1,1,1,1,2,2,1,1,1,1,1,2,1,1,1,2,1,2,1,1,1,1,1,1,2,2,1,1,2,2,1,2,2,1,1,2,2,1,1,1,1,1,1,1,2,2,1,1,1,1,1,2,1,1,1,2,1,2,1,1,1,1,1,1,2,2,5,1,1,1,1,2,2,2,1,2,1,2,1,1,1,1,1,1,2,2,2,2,2,2,2,2,2,2,2,2,2,2,2,2,2,2,2,2,2
2,2,2,2,2,2,2,2,2,2,2,2,2,2,2,2,2,2,2,2,2,1,1,1,1,1,1,1,1,1,1,1,1,1,1,1,1,1,5,2,2,1,2,2,2,2,2,1,1,2,2,2,2,1,2,2,2,2,1,2,2,1,1,1,1,1,1,1,1,1,1,1,1,1,2,2,2,2,1,2,2,1,2,2,1,2,2,1,1,2,2,2,2,1,2,2,2,2,1,2,2,1,2,2,1,2,2,1,1,2,2,2,2,1,1,1,1,1,1,2,2,1,2,2,1,2,2,1,1,2,2,2,2,1,2,2,2,2,1,2,2,1,2,2,1,2,2,1,1,2,2,2,2,1,2,2,2,2,1,2,2,1,1,1,1,1,1,1,1,1,1,1,1,1,1,1,1,1,1,2,2,1,2,2,1,2,2,1,1,2,2,2,2,1,2,2,2,2,1,2,2,1,2,2,1,2,2,1,1,2,2,2,2,1,2,2,2,2,1,2,2,1,2,2,1,2,2,1,1,2,2,2,2,1,1,1,2,2,1,2,2,1,1,1,1,1,1,1,1,1,1,1,1,1,1,1,1,1,1,2,2,1,2,2,1,2,2,2,2,2,1,1,1,1,1,1,2,2,2,2,2,1,2,2,1,2,2,2,2,2,1,1,1,1,1,1,2,2,2,2,2,1,2,2,1,2,2,2,2,2,1,1,6,1,1,1,2,2,2,2,2,1,2,2,1,2,2,2,2,2,1,1,1,1,1,1,2,2,2,2,2,1,1,1,1,1,1,1,1,1,1,1,1,1,1,1,2,2,2,2,2,5,1,2,2,2,2,2,2,2,2,2,2,2,2,2,2,2,2,2,2,2,2,2,2,2,2,2,2,2,2,2,2,2,2,2,2,2,2,2
4,18,5,11,15,5,15,12,5,14,8,5,9,7,5,4,4,5,5,2,5,18,15,4,18,8,4,17,2,4,11,2,4,6,7,4,5,15,4,3,19,4,10,10,3,5,14,3,15,14,3,15,7,3,10,4,3,10,18,3,18,19,3,9,14,2,13,6,2,10,4,2,8,2,2,2,10,2,4,11,2,15,17,2,12,18,1,18,12,1,12,11,1,10,9,1,5,2,1,2,9,1,12,3,1,7,19,1,10,15,1,15,8,1,11,6,1,5,10,1,10,3,1,10,16,2,13,9,2,15,4,2,4,2,2,8,11,2,6,6,2,11,12,3,6,11,3,15,5,3,5,3,3,15,19,3,7,19,3,10,17,4,16,17,4,16,13,4,10,8,4,4,8,4,3,5,4,12,17,5,16,14,5,9,12,5,9,4,5,5,13,5,2,9,5,